R 1920 1080

NO ./textures/bluestone.xpm

SO ./textures/tex_wall_s.xpm

WE ./textures/woman_cat.xpm

EA ./textures/redbrick.xpm

S ./textures/barrel.xpm

F 255,0,100
C 100,255,255

11111111111
100000000N1
10000000201
10000000001
11111111111

