R 1920 1080

NO ./textures/bluestone.xpm

SO ./textures/colorstone.xpm

WE ./textures/greystone.xpm

EA ./textures/redbrick.xpm

S ./textures/barrel.xpm

F 255,0,100
C 100,255,255

11111111111
10010200001
10200000201
1100N000001
11111111111
