R 1920 1080

NO ./textures/bluestone.xpm

SO ./textures/colorstone.xpm

WE ./textures/greystone.xpm

EA ./textures/redbrick.xpm

S ./textures/barrel.xpm

F 255,0,100
C 100,255,255

111111
100101
102001
1100N1
111111
